5 x 5
*****
*H  *
* * *
*  R*
*****
